2852,2852,2852,2852,2852,2852,2852,2852,2852,2852,2852,2852,2852,2852,2852,2852,2852,2852,2852
2852,2852,2852,2852,2852,2852,2852,2852,16,16,16,16,16,3,16,16,16,16,11
2852,2852,16,16,16,16,16,16,16,2852,2852,2852,2852,2852,2852,16,16,16,2852
2852,16,16,2852,2852,2852,2852,2852,2852,2852,2852,2852,2852,2852,2852,2852,2852,16,2852
2852,17,17,17,17,2852,2852,2852,2852,2852,2852,2852,2852,2852,2852,2852,2852,16,2852
2852,16,2852,2852,2852,2852,2852,2852,2852,2852,32,2852,2852,2852,16,2852,2852,16,2852
2852,16,2852,2852,2852,2852,2852,2852,2852,2852,2852,2852,2852,2852,2852,2852,2852,16,2852
2852,16,2852,2852,2852,2852,2852,2852,2852,2852,2852,2852,2852,2852,2852,2852,2852,16,2852
2852,16,2852,2852,2852,2852,2852,2852,2852,2852,2852,2852,2852,2852,2852,2852,2852,16,2852
2852,16,2852,2852,2852,2852,2852,16,16,16,16,16,16,16,16,16,16,16,16
2852,2852,2852,2852,2852,2852,2852,2852,2852,2852,2852,2852,2852,2852,2852,2852,2852,16,2852